19 18 1
18 19 1
18 17 1
17 18 1
17 16 1
16 17 1
16 15 1
15 16 1
15 14 1
14 15 1
14 13 1
13 14 1
13 12 1
12 13 1
12 11 1
11 12 1
11 10 1
10 11 1
10 9 1
9 10 1
9 8 1
8 9 1
8 7 1
7 8 1
7 6 1
6 7 1
6 5 1
5 6 1
5 4 1
4 5 1
4 3 1
3 4 1
3 2 1
2 3 1
2 1 1
1 2 1
1 0 1
0 1 1
